%%%%%%%%%%%%%%%%%%%%%%%%%%%%%%%%%%%%%%%%%%%%%%%%%%%%%%%
%               G                                     %
% %%%%%  % %% %   % %%%%% %    %                      %
% % ..%  %  % %   % %   % %%   %       %%  %%         %
% %   %  %  % %   % % G % % %  %       %%  %%         %
% % %%%  %  % %   % %   % %  % %                      %
% %  %   %  % %   % %% %% %  % %     %        %       %
% % ..%  %  % % % % %   % %  % %      %      %        %
% %   %  %  % % % % %   % %  % %      %      %        %
% %   %  %  % % % % %   % %   %%       %%  %%         %
% %  . % %  % % % % %   % %   %%         %%           %
% %    % %%%% %% %% %   % %    %                      %
%                                                     %
%    ...........                                   P  %
%%%%%%%%%%%%%%%%%%%%%%%%%%%%%%%%%%%%%%%%%%%%%%%%%%%%%%%
